NO textures/wall_1.png
SO textures/sky_1.png
WE textures/sprite_1.png
EA textures/wood.png

F 184,113,39
C 51,198,227

1111111111111111111111111
1000000000110000000000001
1011000001000000000000001
100100000000000000000000111111111
1000000000110000000000001
1011000001000000N00000001
100100000000000000000000111111111
111111111011000001110000000000001
100000000011000001110111111111111
11110111111111011100000010001
111101111111110111010100100001
11000000110101011100000010001
10000000000000001100000010001
10000000000000001101010000001
1100000111010101111101111000111
11110111 1110101 101111010001
11111111 1111111 111111111111