NO textures/wall_1.png
SO textures/wall_2.png
WE textures/wall_3.png
EA textures/wall_4.png
S textures/sprite_1.png
ST textures/sky_1.png
FT textures/floor_1.png

F 0,0,0
C 55,5,0

        1111111111111111111111111
        1000000000110000000000001
        1011000001110000000000001
        1001000000000000000000001
111111111011000001110000000000001
100000000011000011101111111111111
11110111111111011100000010001
11110111111111011101010010001
11000000110101011100000010001
10000000W00000001100000010001
10000000000000001101010010001
11000001110101011111011110001
11110111 1110101 101111010001
11111111 1111111 111111111111