
NO textures/wall_1.png
SO textures/wall_2.png
WE textures/wall_3.png
EA textures/wall_4.png

F 184,113,39
C 51,198,227

1111111111111111111111111
1000000000000000000000001
1000000000000000000000001
1000000000000000000000001
1000000000000000000000001
1100000000000000000000001
1100000000000000000000001
1111111111111111111111111
